000000000000000000000000000000000000000000000000000n
000000000000000000000000000000000000000000000000000n
000000000000000000000000000000000000000000000000000n
000000000000000000000000000000000000000000000000000n
000000000000000000000000000000000000000000000000000n
000000000000000000000000000ll0000000000000000000000n
000000000000000000000000llllllll0000000000000000000n
00000000000000000000000llllllllll000000000000000000n
00000000000000000000#00llllllllll000000000000000000n
00000000000000000000000000lwwl000000000000000000000n
000000000000000000000000000ww0000000000000000000000n
00000000000000000000#000000ww0000000000000000000000n
000000000000000000000000000ww0000000000000000000000n
000000000000000000000000000ww0000000000000000000000n
gggggggggggggggggggggggggggggggggggggggggggggggggggn
rrrrrrrrrrrrrrrrrrrrrrrrrrrrrrrrrrrrrrrrrrrrrrrrrrrn
###################################################n
###################################################n
###################################################
