000000000000000000000000000000000000000000000000000000000n
000000000000000000000000000000000000000000000000000000000n
000000000000000000000000000000000000000000000000000000000n
000000000000000000000000000000000000000000000000000000000n
000000000000000000000000000000000000000000000000000000000n
000000000000000000000000000000000000000000000000000000000n
000000000000000000000000000000000000000000000000000000000n
000000000000000000000000000000000000000000000000000000000n
000000000000000000000000000000000000000000000000000000000n
000000000000000000000000000000000000000000000000000000000n
000000000000000000000000000000000000000000000000000000000n
000000000000000000000000000000000000000000000000000000000n
000000000000000000000000000000000000000000000000000000000n
000000000000000000000000000000000000000000000000000000000n
000000000000000000000000000000000000000000000000000000000n
000000000000000lll000000000000000000000000000000000000000n
00000000000000lllll00000000000000000000000000000000000000n
0000000000000000w0000000000000000000000000000000000000000n
0000000000000000w0000000000000000000000000000000000000000n
gggggggggggggggggggggggggggggggggggggggggggggggggggggggggn
rrrrrrrrrrrrrrrrrrrrrrrrrrrrrrrrrrrrrrrrrrrrrrrrrrrrrrrrrn
#########################################################n
#########################################################n
#########################################################
