00000000000000000000000000000000000000000000000000000n
00000000000000000000000000000000000000000000000000000n
00000000000000000000000000000000000000000000000000000n
00000000000000000000000000000000000000000000000000000n
00000000000000000000000000000000000000000000000000000n
00000000000000000000000000000000000000000000000000000n
00000000000000000000000000000000000000000000000000000n
00000000000lll000000000000000000000000000000000000000n
0000000000lllll00000000000000000000000000000000000000n
000000000000w0000000000000000000000000s00000000000000n
000000000000w0000000000000000000000000000000000000000n
000000000000w0000000000000000000000000000000000000000n
ggggggggggg0gggggggggg0ggggggggggggggggggggggggggggggn
rrrrrrrrrrr0rrrrrrrrrr0rrrrrrrrrrrrrrrrrrrrrrrrrrrrrrn
###########000000000000##############################n
#####s000s#00########################################n
########0##0#########################################n
########0000#########################################n
#####################################################
